2
10 10
1 1 1 1 1 1 1 1 1 1
1 0 0 0 0 0 0 0 0 1
1 0 1 1 1 1 1 1 0 1
1 0 1 0 0 0 0 1 0 1
1 0 1 0 1 1 0 1 0 1
1 0 1 0 0 0 0 1 0 1
1 0 1 1 1 1 1 1 0 1
1 0 0 0 0 0 0 0 0 1
1 1 1 1 1 1 1 1 1 1
1 0 0 0 0 0 0 0 0 1
5 5 90.0

8 12
1 1 1 1 1 1 1 1
1 0 0 0 0 0 0 1
1 0 1 1 1 1 0 1
1 0 1 0 0 1 0 1
1 0 1 0 1 1 0 1
1 0 1 0 0 0 0 1
1 0 1 1 1 1 0 1
1 0 0 0 0 0 0 1
1 1 1 1 1 1 1 1
1 0 0 0 0 0 0 1
1 1 1 1 1 1 1 1
1 1 1 1 1 1 1 1
3 3 0.0
